111111111111111111
111111100011111111
110000000P00000111
1110000C0000000011
111111110000000001
1111111EC000000001
111111111111111111