111111111111111111111
100000E00000000000C01
1000P0000C001000000C1
100000C00000100000101
111111111111111111111
