111111
10PC01
111111
111111
111111
111111
111111
111111
111111
11C111
111111
