111111111111111111111
1000P0000C00000000C01
100000001110000000001
100000000000000111001
10000C000000111000001
10000000000000000E001
10000C000000000000001
111111111111111111111