111111111111111111111
100001E00000000000C01
1000P1010C001111000C1
100000C00000100000101
111111111111111111111
