111111
1EPC01
111111
111111
111111
111111
111111
111111
111111
11C111
111111
