1111111111111111
1000000000000XC1
1000000000000001
10000000X0000001
1000000XCX000001
10000000X0000001
1000000000000001
1P000000000000E1
1111111111111111
