111111111111111111111111111111
1ECCCCCCCCCCC00CCCCCCCCCCCCCC1
1PCCCCCCCCCCC00CCCCCCCCC0CCCC1
1CCCCCCCCCCCC00CCCCCCCCCCCCCC1
1CCCCCCCCCCCC00CCCCCCCCCCCCCC1
1CCCCCCCCCCCC00CCCCCCCCCCCCCC1
1CCCCCCCCCCCC00CCCCCCCCCCCCCC1
1CCCCCCCCCCCC00CCCCCCCCC0CCCC1
1CCCCCCCCCCCC00CCCCCCCCCCCCCC1
1CCCCCCCCCCCC00CCCCCCCCCCCCCC1
1CCCCCCCCCCCC00CCCCCCCCCCCCCC1
1CCCCCCCCCCCC00CCCCCCCCCCCCCC1
1CCCCCCCCCCCC00CCCCCCCCCCCCCC1
1CCCCCCCCCCCC00CCCCCCCCCCCCCC1
1CCCCCCCCCCCC00CCCCCCCCCCCCCC1
111111111111111111111111111111
