11111111111111111111
1P001110C00000100001
10000100000010010C01
100C0010000001000001
1000000000C000011001
1C00C000100000000011
11100000000100000001
1C00C00E010000000001
10000000C10000000001
11111111111111111111