1111111111111111
1000000000000CC1
1000000000000001
10000000C0000001
1000000CCC000001
10000000C0000001
1000000000000001
1P000000000000E1
1111111111111111
