111111111111111111111111111111
100000000000000C00000C00000001
101001010010000010100100000001
101001001010101000100110000011
1P0000000C00C000000000E000C001
100011100111100111100111100001
100001100001100001100001100001
100001100111100111100001100001
100001100001100001100001100001
100001100111100111100001100001
100000010000000000C10000000001
100000C00000010001110000000001
100000000000010000000000000001
100000C0000001000000000000C001
1000000000000000C0000000000001
111111111111111111111111111111