11111111111111111111111111111111111111111111111
100000000000000C00000C0000000000000000011111111
10100101001000001010010000000101000000011111111
10100100101010100010010000000101000000011111111
1P0000000C00C000000000E000000000C00000011111111
10000000000000000000000000000000000000011111111
10000000000000000000000000000000000000011111111
10000000000000000000000000000000000000011111111
10000000000000000000000000000000000000011111111
100000C0000000000000000000000000000000011111111
100000000000000000C0000000000000000000011111111
100000C0000001000000000000000000000000011111111
10000000000001000000000000000000000000011111111
10000000000001000000000000C00000000000011111111
1000000000000000C000000000000000000000011111111
10000000000000000000000000000000000000011111111
11111111111111111111111111111111100000011111111
100000C0000001000000000000000000000000011111111
10000000000001000000000000000000000000011111111
10000000000001000000000000C00000000000011111111
1000000000000000C000000000000000000000011111111
10000000000000000000000000000000000000011111111
11111111111111111111111111111111100000011111111
100000C0000001000000000000000000000000011111111
10000000000001000000000000000000000000011111111
10000000000001000000000000C00000000000011111111
1000000000000000C000000000000000000000011111111
10000000000000000000000000000000000000011111111
11111111111111111111111111111111111111111111111
