111111111111111111111111111111
100000000000000C00000C00000001
101001010010000010100100000001
101001001010101000100100000011
1P0000000C00C000000000E0000001
100000000000000000000000000001
100000000000000000000000000001
100000000000000000000000000001
100000000000000000000000000001
100000C00000000000000000000001
100000000000000000C00000000001
100000C00000010000000000000001
100000000000010000000000000001
10000000000001000000000000C001
1000000000000000C0000000000001
111111111111111111111111111111