1111111111111111111111111111111111111111111111111111111111111111111111111111111111111111111111111111111111111111111111111111111111111111
100000000000000C00000C000000000001111111111111111111111111111111111111111111111111111111111111111111111111111111111111111111111111111111
1010010100100000101001000000010101111111111111111111111111111111111111111111111111111111111111111111111111111111111111111111111111111111
1010010010101010001001000000010101111111111111111111111111111111111111111111111111111111111111111111111111111111111111111111111111111111
1P0000000C00C000000000E000000000C1111111111111111111111111111111111111111111111111111111111111111111111111111111111111111111111111111111
1000000000000000000000000000000001111111111111111111111111111111111111111111111111111111111111111111111111111111111111111111111111111111
1000000000000000000000000000000001111111111111111111111111111111111111111111111111111111111111111111111111111111111111111111111111111111
1000000000000000000000000000000001111111111111111111111111111111111111111111111111111111111111111111111111111111111111111111111111111111
1000000000000000000000000000000001111111111111111111111111111111111111111111111111111111111111111111111111111111111111111111111111111111
100000C000000000000000000000000001111111111111111111111111111111111111111111111111111111111111111111111111111111111111111111111111111111
100000000000000000C000000000000001111111111111111111111111111111111111111111111111111111111111111111111111111111111111111111111111111111
100000C000000100000000000000000001111111111111111111111111111111111111111111111111111111111111111111111111111111111111111111111111111111
1000000000000100000000000000000001111111111111111111111111111111111111111111111111111111111111111111111111111111111111111111111111111111
10000000000001000000000000C0000001111111111111111111111111111111111111111111111111111111111111111111111111111111111111111111111111111111
1000000000000000C00000000000000001111111111111111111111111111111111111111111111111111111111111111111111111111111111111111111111111111111
1000000000000000000000000000000001111111111111111111111111111111111111111111111111111111111111111111111111111111111111111111111111111111
1111111111111111111111111111111111111111111111111111111111111111111111111111111111111111111111111111111111111111111111111111111111111111
100000C000000100000000000000000001111111111111111111111111111111111111111111111111111111111111111111111111111111111111111111111111111111
1000000000000100000000000000000001111111111111111111111111111111111111111111111111111111111111111111111111111111111111111111111111111111
10000000000001000000000000C0000001111111111111111111111111111111111111111111111111111111111111111111111111111111111111111111111111111111
1000000000000000C00000000000000001111111111111111111111111111111111111111111111111111111111111111111111111111111111111111111111111111111
1000000000000000000000000000000001111111111111111111111111111111111111111111111111111111111111111111111111111111111111111111111111111111
1111111111111111111111111111111111111111111111111111111111111111111111111111111111111111111111111111111111111111111111111111111111111111
100000C000000100000000000000000001111111111111111111111111111111111111111111111111111111111111111111111111111111111111111111111111111111
1000000000000100000000000000000001111111111111111111111111111111111111111111111111111111111111111111111111111111111111111111111111111111
10000000000001000000000000C0000001111111111111111111111111111111111111111111111111111111111111111111111111111111111111111111111111111111
1000000000000000C00000000000000001111111111111111111111111111111111111111111111111111111111111111111111111111111111111111111111111111111
1000000000000000000000000000000001111111111111111111111111111111111111111111111111111111111111111111111111111111111111111111111111111111
1111111111111111111111111111111111111111111111111111111111111111111111111111111111111111111111111111111111111111111111111111111111111111
100000C000000100000000000000000001111111111111111111111111111111111111111111111111111111111111111111111111111111111111111111111111111111
1000000000000100000000000000000001111111111111111111111111111111111111111111111111111111111111111111111111111111111111111111111111111111
10000000000001000000000000C0000001111111111111111111111111111111111111111111111111111111111111111111111111111111111111111111111111111111
1000000000000000C00000000000000001111111111111111111111111111111111111111111111111111111111111111111111111111111111111111111111111111111
1000000000000000000000000000000001111111111111111111111111111111111111111111111111111111111111111111111111111111111111111111111111111111
1111111111111111111111111111111111111111111111111111111111111111111111111111111111111111111111111111111111111111111111111111111111111111
100000C000000100000000000000000001111111111111111111111111111111111111111111111111111111111111111111111111111111111111111111111111111111
1000000000000100000000000000000001111111111111111111111111111111111111111111111111111111111111111111111111111111111111111111111111111111
10000000000001000000000000C0000001111111111111111111111111111111111111111111111111111111111111111111111111111111111111111111111111111111
1000000000000000C00000000000000001111111111111111111111111111111111111111111111111111111111111111111111111111111111111111111111111111111
1000000000000000000000000000000001111111111111111111111111111111111111111111111111111111111111111111111111111111111111111111111111111111
1111111111111111111111111111111111111111111111111111111111111111111111111111111111111111111111111111111111111111111111111111111111111111
100000C000000100000000000000000001111111111111111111111111111111111111111111111111111111111111111111111111111111111111111111111111111111
1000000000000100000000000000000001111111111111111111111111111111111111111111111111111111111111111111111111111111111111111111111111111111
10000000000001000000000000C0000001111111111111111111111111111111111111111111111111111111111111111111111111111111111111111111111111111111
1000000000000000C00000000000000001111111111111111111111111111111111111111111111111111111111111111111111111111111111111111111111111111111
1000000000000000000000000000000001111111111111111111111111111111111111111111111111111111111111111111111111111111111111111111111111111111
1111111111111111111111111111111111111111111111111111111111111111111111111111111111111111111111111111111111111111111111111111111111111111
100000C000000100000000000000000001111111111111111111111111111111111111111111111111111111111111111111111111111111111111111111111111111111
1000000000000100000000000000000001111111111111111111111111111111111111111111111111111111111111111111111111111111111111111111111111111111
10000000000001000000000000C0000001111111111111111111111111111111111111111111111111111111111111111111111111111111111111111111111111111111
1000000000000000C00000000000000001111111111111111111111111111111111111111111111111111111111111111111111111111111111111111111111111111111
1000000000000000000000000000000001111111111111111111111111111111111111111111111111111111111111111111111111111111111111111111111111111111
1111111111111111111111111111111111111111111111111111111111111111111111111111111111111111111111111111111111111111111111111111111111111111
100000C000000100000000000000000001111111111111111111111111111111111111111111111111111111111111111111111111111111111111111111111111111111
1000000000000100000000000000000001111111111111111111111111111111111111111111111111111111111111111111111111111111111111111111111111111111
10000000000001000000000000C0000001111111111111111111111111111111111111111111111111111111111111111111111111111111111111111111111111111111
1000000000000000C00000000000000001111111111111111111111111111111111111111111111111111111111111111111111111111111111111111111111111111111
1000000000000000000000000000000001111111111111111111111111111111111111111111111111111111111111111111111111111111111111111111111111111111
1111111111111111111111111111111111111111111111111111111111111111111111111111111111111111111111111111111111111111111111111111111111111111
100000C000000100000000000000000001111111111111111111111111111111111111111111111111111111111111111111111111111111111111111111111111111111
1000000000000100000000000000000001111111111111111111111111111111111111111111111111111111111111111111111111111111111111111111111111111111
10000000000001000000000000C0000001111111111111111111111111111111111111111111111111111111111111111111111111111111111111111111111111111111
1000000000000000C00000000000000001111111111111111111111111111111111111111111111111111111111111111111111111111111111111111111111111111111
1000000000000000000000000000000001111111111111111111111111111111111111111111111111111111111111111111111111111111111111111111111111111111
1111111111111111111111111111111111111111111111111111111111111111111111111111111111111111111111111111111111111111111111111111111111111111
100000C000000100000000000000000001111111111111111111111111111111111111111111111111111111111111111111111111111111111111111111111111111111
1000000000000100000000000000000001111111111111111111111111111111111111111111111111111111111111111111111111111111111111111111111111111111
10000000000001000000000000C0000001111111111111111111111111111111111111111111111111111111111111111111111111111111111111111111111111111111
1000000000000000C00000000000000001111111111111111111111111111111111111111111111111111111111111111111111111111111111111111111111111111111
1000000000000000000000000000000001111111111111111111111111111111111111111111111111111111111111111111111111111111111111111111111111111111
1111111111111111111111111111111111111111111111111111111111111111111111111111111111111111111111111111111111111111111111111111111111111111
100000C000000100000000000000000001111111111111111111111111111111111111111111111111111111111111111111111111111111111111111111111111111111
1000000000000100000000000000000001111111111111111111111111111111111111111111111111111111111111111111111111111111111111111111111111111111
10000000000001000000000000C0000001111111111111111111111111111111111111111111111111111111111111111111111111111111111111111111111111111111
1000000000000000C00000000000000001111111111111111111111111111111111111111111111111111111111111111111111111111111111111111111111111111111
1000000000000000000000000000000001111111111111111111111111111111111111111111111111111111111111111111111111111111111111111111111111111111
1111111111111111111111111111111111111111111111111111111111111111111111111111111111111111111111111111111111111111111111111111111111111111
100000C000000100000000000000000001111111111111111111111111111111111111111111111111111111111111111111111111111111111111111111111111111111
1000000000000100000000000000000001111111111111111111111111111111111111111111111111111111111111111111111111111111111111111111111111111111
10000000000001000000000000C0000001111111111111111111111111111111111111111111111111111111111111111111111111111111111111111111111111111111
1000000000000000C00000000000000001111111111111111111111111111111111111111111111111111111111111111111111111111111111111111111111111111111
100000C000000100000000000000000001111111111111111111111111111111111111111111111111111111111111111111111111111111111111111111111111111111
1111111111111111111111111111111111111111111111111111111111111111111111111111111111111111111111111111111111111111111111111111111111111111
1000000000000000000000000000000001111111111111111111111111111111111111111111111111111111111111111111111111111111111111111111111111111111
1111111111111111111111111111111111111111111111111111111111111111111111111111111111111111111111111111111111111111111111111111111111111111
100000000000000C00000C000000000001111111111111111111111111111111111111111111111111111111111111111111111111111111111111111111111111111111
1010010100100000101001000000010101111111111111111111111111111111111111111111111111111111111111111111111111111111111111111111111111111111
1010010010101010001001000000010101111111111111111111111111111111111111111111111111111111111111111111111111111111111111111111111111111111
1P0000000C00C0000000000000000000C1111111111111111111111111111111111111111111111111111111111111111111111111111111111111111111111111111111
1000000000000000000000000000000001111111111111111111111111111111111111111111111111111111111111111111111111111111111111111111111111111111
1000000000000000000000000000000001111111111111111111111111111111111111111111111111111111111111111111111111111111111111111111111111111111
1000000000000000000000000000000001111111111111111111111111111111111111111111111111111111111111111111111111111111111111111111111111111111
1000000000000000000000000000000001111111111111111111111111111111111111111111111111111111111111111111111111111111111111111111111111111111
100000C000000000000000000000000001111111111111111111111111111111111111111111111111111111111111111111111111111111111111111111111111111111
100000000000000000C000000000000001111111111111111111111111111111111111111111111111111111111111111111111111111111111111111111111111111111
100000C000000100000000000000000001111111111111111111111111111111111111111111111111111111111111111111111111111111111111111111111111111111
1000000000000100000000000000000001111111111111111111111111111111111111111111111111111111111111111111111111111111111111111111111111111111
10000000000001000000000000C0000001111111111111111111111111111111111111111111111111111111111111111111111111111111111111111111111111111111
1000000000000000C00000000000000001111111111111111111111111111111111111111111111111111111111111111111111111111111111111111111111111111111
1000000000000000000000000000000001111111111111111111111111111111111111111111111111111111111111111111111111111111111111111111111111111111
1111111111111111111111111111111111111111111111111111111111111111111111111111111111111111111111111111111111111111111111111111111111111111
100000C000000100000000000000000001111111111111111111111111111111111111111111111111111111111111111111111111111111111111111111111111111111
1000000000000100000000000000000001111111111111111111111111111111111111111111111111111111111111111111111111111111111111111111111111111111
10000000000001000000000000C0000001111111111111111111111111111111111111111111111111111111111111111111111111111111111111111111111111111111
1000000000000000C00000000000000001111111111111111111111111111111111111111111111111111111111111111111111111111111111111111111111111111111
1000000000000000000000000000000001111111111111111111111111111111111111111111111111111111111111111111111111111111111111111111111111111111
1111111111111111111111111111111111111111111111111111111111111111111111111111111111111111111111111111111111111111111111111111111111111111
100000C000000100000000000000000001111111111111111111111111111111111111111111111111111111111111111111111111111111111111111111111111111111
1000000000000100000000000000000001111111111111111111111111111111111111111111111111111111111111111111111111111111111111111111111111111111
10000000000001000000000000C0000001111111111111111111111111111111111111111111111111111111111111111111111111111111111111111111111111111111
1000000000000000C00000000000000001111111111111111111111111111111111111111111111111111111111111111111111111111111111111111111111111111111
1000000000000000000000000000000001111111111111111111111111111111111111111111111111111111111111111111111111111111111111111111111111111111
1111111111111111111111111111111111111111111111111111111111111111111111111111111111111111111111111111111111111111111111111111111111111111
100000C000000100000000000000000001111111111111111111111111111111111111111111111111111111111111111111111111111111111111111111111111111111
1000000000000100000000000000000001111111111111111111111111111111111111111111111111111111111111111111111111111111111111111111111111111111
10000000000001000000000000C0000001111111111111111111111111111111111111111111111111111111111111111111111111111111111111111111111111111111
1000000000000000C00000000000000001111111111111111111111111111111111111111111111111111111111111111111111111111111111111111111111111111111
1000000000000000000000000000000001111111111111111111111111111111111111111111111111111111111111111111111111111111111111111111111111111111
1111111111111111111111111111111111111111111111111111111111111111111111111111111111111111111111111111111111111111111111111111111111111111
100000C000000100000000000000000001111111111111111111111111111111111111111111111111111111111111111111111111111111111111111111111111111111
1000000000000100000000000000000001111111111111111111111111111111111111111111111111111111111111111111111111111111111111111111111111111111
10000000000001000000000000C0000001111111111111111111111111111111111111111111111111111111111111111111111111111111111111111111111111111111
1000000000000000C00000000000000001111111111111111111111111111111111111111111111111111111111111111111111111111111111111111111111111111111
1000000000000000000000000000000001111111111111111111111111111111111111111111111111111111111111111111111111111111111111111111111111111111
1111111111111111111111111111111111111111111111111111111111111111111111111111111111111111111111111111111111111111111111111111111111111111
100000C000000100000000000000000001111111111111111111111111111111111111111111111111111111111111111111111111111111111111111111111111111111
1000000000000100000000000000000001111111111111111111111111111111111111111111111111111111111111111111111111111111111111111111111111111111
10000000000001000000000000C0000001111111111111111111111111111111111111111111111111111111111111111111111111111111111111111111111111111111
1000000000000000C00000000000000001111111111111111111111111111111111111111111111111111111111111111111111111111111111111111111111111111111
1000000000000000000000000000000001111111111111111111111111111111111111111111111111111111111111111111111111111111111111111111111111111111
1111111111111111111111111111111111111111111111111111111111111111111111111111111111111111111111111111111111111111111111111111111111111111
100000C000000100000000000000000001111111111111111111111111111111111111111111111111111111111111111111111111111111111111111111111111111111
1000000000000100000000000000000001111111111111111111111111111111111111111111111111111111111111111111111111111111111111111111111111111111
10000000000001000000000000C0000001111111111111111111111111111111111111111111111111111111111111111111111111111111111111111111111111111111
1000000000000000C00000000000000001111111111111111111111111111111111111111111111111111111111111111111111111111111111111111111111111111111
1000000000000000000000000000000001111111111111111111111111111111111111111111111111111111111111111111111111111111111111111111111111111111
1111111111111111111111111111111111111111111111111111111111111111111111111111111111111111111111111111111111111111111111111111111111111111
100000C000000100000000000000000001111111111111111111111111111111111111111111111111111111111111111111111111111111111111111111111111111111
1000000000000100000000000000000001111111111111111111111111111111111111111111111111111111111111111111111111111111111111111111111111111111
10000000000001000000000000C0000001111111111111111111111111111111111111111111111111111111111111111111111111111111111111111111111111111111
1000000000000000C00000000000000001111111111111111111111111111111111111111111111111111111111111111111111111111111111111111111111111111111
1000000000000000000000000000000001111111111111111111111111111111111111111111111111111111111111111111111111111111111111111111111111111111
1111111111111111111111111111111111111111111111111111111111111111111111111111111111111111111111111111111111111111111111111111111111111111
100000C000000100000000000000000001111111111111111111111111111111111111111111111111111111111111111111111111111111111111111111111111111111
1000000000000100000000000000000001111111111111111111111111111111111111111111111111111111111111111111111111111111111111111111111111111111
10000000000001000000000000C0000001111111111111111111111111111111111111111111111111111111111111111111111111111111111111111111111111111111
1000000000000000C00000000000000001111111111111111111111111111111111111111111111111111111111111111111111111111111111111111111111111111111
1000000000000000000000000000000001111111111111111111111111111111111111111111111111111111111111111111111111111111111111111111111111111111
1111111111111111111111111111111111111111111111111111111111111111111111111111111111111111111111111111111111111111111111111111111111111111
100000C000000100000000000000000001111111111111111111111111111111111111111111111111111111111111111111111111111111111111111111111111111111
1000000000000100000000000000000001111111111111111111111111111111111111111111111111111111111111111111111111111111111111111111111111111111
10000000000001000000000000C0000001111111111111111111111111111111111111111111111111111111111111111111111111111111111111111111111111111111
1000000000000000C00000000000000001111111111111111111111111111111111111111111111111111111111111111111111111111111111111111111111111111111
1000000000000000000000000000000001111111111111111111111111111111111111111111111111111111111111111111111111111111111111111111111111111111
1111111111111111111111111111111111111111111111111111111111111111111111111111111111111111111111111111111111111111111111111111111111111111
100000C000000100000000000000000001111111111111111111111111111111111111111111111111111111111111111111111111111111111111111111111111111111
1000000000000100000000000000000001111111111111111111111111111111111111111111111111111111111111111111111111111111111111111111111111111111
10000000000001000000000000C0000001111111111111111111111111111111111111111111111111111111111111111111111111111111111111111111111111111111
1000000000000000C00000000000000001111111111111111111111111111111111111111111111111111111111111111111111111111111111111111111111111111111
1000000000000000000000000000000001111111111111111111111111111111111111111111111111111111111111111111111111111111111111111111111111111111
1111111111111111111111111111111111111111111111111111111111111111111111111111111111111111111111111111111111111111111111111111111111111111
100000C000000100000000000000000001111111111111111111111111111111111111111111111111111111111111111111111111111111111111111111111111111111
1000000000000100000000000000000001111111111111111111111111111111111111111111111111111111111111111111111111111111111111111111111111111111
10000000000001000000000000C0000001111111111111111111111111111111111111111111111111111111111111111111111111111111111111111111111111111111
1000000000000000C00000000000000001111111111111111111111111111111111111111111111111111111111111111111111111111111111111111111111111111111
100000C000000100000000000000000001111111111111111111111111111111111111111111111111111111111111111111111111111111111111111111111111111111
1111111111111111111111111111111111111111111111111111111111111111111111111111111111111111111111111111111111111111111111111111111111111111
1111111111111111111111111111111111111111111111111111111111111111111111111111111111111111111111111111111111111111111111111111111111111111
1111111111111111111111111111111111111111111111111111111111111111111111111111111111111111111111111111111111111111111111111111111111111111
1111111111111111111111111111111111111111111111111111111111111111111111111111111111111111111111111111111111111111111111111111111111111111
