1111111111111111111111111111111111
1ECCCCCCCCCCC00CCCCCCCCCCCCCCCCCC1
1PCCCCCCCCCCC00CCCCCCCCC0CCCCCCCC1
1CCCCCCCCCCCC00CCCCCCCCCCCCCCCCCC1
1CCCCCCCCCCCC00CCCCCCCCCCCCCCCCCC1
1CCCCCCCCCCCC00CCCCCCCCCCCCCCCCCC1
1CCCCCCCCCCCC00CCCCCCCCCCCCCCCCCC1
1CCCCCCCCCCCC00CCCCCCCCC0CCCCCCCC1
1CCCCCCCCCCCC00CCCCCCCCCCCCCCCCCC1
1CCCCCCCCCCCC00CCCCCCCCCCCCCCCCCC1
1CCCCCCCCCCCC00CCCCCCCCCCCCCCCCCC1
1CCCCCCCCCCCC00CCCCCCCCCCCCCCCCCC1
1CCCCCCCCCCCC00CCCCCCCCCCCCCCCCCC1
1CCCCCCCCCCCC00CCCCCCCCCCCCCCCCCC1
1CCCCCCCCCCCC00CCCCCCCCCCCCCCCCCC1
1CCCCCCCCCCCC00CCCCCCCCCCCCCCCCCC1
1111111111111111111111111111111111
