11111111111111111111
1P000000C10000000001
10000000010000000001
1000C000010000000001
10000000010000000001
1C00C000010000000001
10000000010000000001
1C00C00E010000000001
10000000C10000000001
11111111111111111111